%%%%%%%%%%%
%G       .%
% %%% %%% %
%P  %   %G%
%  %% % %%%
%   % %  .%
%%% % %%% %
% % %   % %
% % %%%%% %
%.       G%
%%%%%%%%%%%