%%%%%%%%%%%
%        .%
% %%% %%% %
%P  %   % %
%  %% % %%%
%   % %  .%
%%% % %%% %
% % %   % %
% % %%%%% %
%.       G%
%%%%%%%%%%%