%%%%%%%%%%%
%.........%
%.%%%.%%%.%
%P..%.....%
%..%%.%.%%%
%...%.%...%
%%%.%.%%%.%
%.%.%...%.%
%.%.%%%%%.%
%........G%
%%%%%%%%%%%